***X***X****X*X************X**X*X******X****XX******X*X*X****XX***X*****X*XX****X*XXX************X**X*X*X**X****X*X*****X*****X****X****X*X****XX******XXXXX***X
XX*XXX***X*X***XXXXXX*XXXX**X*****X*X*X**XX****XXXX*X*****XX***X*XX*X*X******X*X***X**X*X*XX*XX*X**X******X**XX*****XXX**XX*X*X*X*XX*XX*****X*X***XXXX**XXX**X**
*X***XX*X****X*X******X***X*X*XXXX***X**XX*XX*XX**X***XXXXXXXX*X****XX*XXX*XX**X*X**X*XX*X***XX*X*X**XXXX*X*XX*X*X*X***X*XX*X*X*X*****XX*X*XXX**XXX***X**X**X*X*
**XX***XX*XXXX***XXX*X**XX**X*****XX***X*****X***X*XXX****XX***X*XXX******X*X*X***X*X****X*XX***X*X*X***X******X**X**XXX****X**X**X*X***X**XX**XX***X**X***X****
X***XX*X**X***XXX***X**XX**X*XX*X***XXX**XX*X**X*X*X***X*X***XX**X**X*XXX***X***XX***X*X*X*XX*X*X*X*X*X**X*X*XX*X**X****XX*X*X*X*XXX*XX**X****X***X**X*X*XX**X*X
**X**X***X**XX****X***X***X****X**X*X**X**X*X*XX*X*X*X**XX*XX**X*XX******X*XXXXX***X**XX*X***X****X*X**XXX**X***X*X**XX***X**X*X**X****X**XXXX**X**XXX***XX*XXX*
*X*XX*XXX*X***X*XXXXXX**XX**XX**XXX**X***X****X****X**X****X*X****XX*X*X*X**X***X*X**X***XXX**X*XXX***X***X*X*X***X*X**X*X**XX*X*X**XX**X****X*XX*X***X*X***XX**
*X******X***X*****X****X***X*XX****X**XX**X*XX*XXXXX*X*XXXX**X*XX***X**X**XX**X****XX**XX***X**X***X*X**X**X***XXX****X****X****X**X***XXX*X*X*X**X*X*XX**X****X
***XXXX**XX**XXXX***XXX**X*****XXX**X***X**X*********X*****X***X*XX**X**X**X*XX*X*X***X*X*X**X***X***X*XXX*X*XX***XX*X**X*X**X*X**X**XX*X***X**X*X**X***X*XX*XX*
X*X***XX****XX***XXX***X**X*X*X**XX*X*X*XX*X*X*X*XX*X**XX*XXXXX****X**X*XX*X***X**X*XXX****X**XX*XXXX***X**X****X*X***X*X**X**X**X*X**X*X*X*X*X*X**X**X*X**XX***
**X*X***XXXX***X*X***X*XXX*X***X****X*X**X****X**X*X*X**X**X****XX**X**XX***XX**X*X****X*XX**X**X****X*X**XX*XXX**XXXX**X*X*X*X*X***X*X*X**XX*****XX*XX**XX***X*
*X***XXX****X*X**XX*XX*******XX**XXXX**X**X*XX**XX***XX**X***X*X***X*X****XX*X*X***XXX**X***X**X**XX***X*X*****X*X****X**X**X*X***X*X*X**X***XXX*X*****X****XX**
**XX***X*XX***X*X***X**XXXXXX***X*****X*X**XX**X***X***X**XXX*XXX*X***XXX****X**X*X**XX***X*X*X**X***XXX**XXX*XX**X*X*XX***X***X*XX*X*XX***XX***X*X*XX*X*XXX**X*
X***XX*****X*X***X*X**X******X*X**XX*X***X***X***XX*XX*XX***X**X**X*X*X**XX*X**X***X***X*X**X*X*X*XXX***X****X***X**X***X*X*XX**X***X***XXX***X****X****X****X**
**X***X*XX*X*X*X***XXX**XXXX***XX***X**XX*XX**XX**X**X***XX**X***XX*X***X***X*X*XX**XX**X**X**X*******X**X*X***XX**X*XX***X***X***XX**XX****XX*X*X*X*XX***XX**X*
*X**X**X*X*X**X*X*X***XXX***XX***XX**X******X*X**X**X*XX****X**XX***XX*X**XXX*X***X*X**XX*X*X**XXXX*XX*X**XXXXXXX*X****XX**X*X*X*X*X*X***X*XX***XX*X**X*X***XXX*
X**XXX*X*X**X***XX**X*****X*X*XX***X**XX*X*X**X*X**X***XXXXX**XX*XX**X*X*X****X*X****X*X**X***X****X****X**X***X**X*XXX**X*X****X**X*X*XXXX***X****XXX***X*X****
**XXX**X*X*X*XX****X*XX*XX**X***XX*XX*****X**X*X**XX*XX******X*****XXX***X*XXX*X**X*X**X*XXX*XXXX*XX*X*XXX**XX***XX****X***X*XX*X*X**X***X**XX*XXXX***XXXX*X*XX*
*XXX**X**X*X***XXXX****X*X*XXX*XXX**X*X*XXX*X****X***X**XX*XX**XXX****XX*X***X***X****X**XX***X***X**X**X**X***XX***XX***XX***X*X*X*X**X**X**X*X****X*X***XX**X*
**X**X*X****XX*X***X*XX**X**X**XX*X*X**X****XX*X*XX*X**X**X***X**XXXX***X**X**XXX**XXX**X***X***X*X*XXX*X*X**X**XXX**XXX***X*X**X*X**XX**X*X****XXX*X***X***X**X
*X**X****XX**X**XX******XXX**X****X**XX**XXX***X**X**X**X**X*XXX*****XX**X**X****X*X***X**X**X*XXX**XX**X**X*XXX***XX***XX*X**X***XX***X*X**XXX*****XXXXXXX**X**
X**X*XXX*X*X**X**XX*X*XX*X*X**X*X**X***X*X**XX**X**X**X**X****X**X*X***X**X**XXX*XX**X*X*XX*XX**X**X***XX*X****X*X*X**X*X**XX**XX***XX***X*X**XXXXXX****X**X**X*
**X*****X***X**X****X*******X*X**XX*XX***X*X***XX*X**X*X*X*XX*X*X*X**X*XX**X*X*X****X***XX****X*X*X**XX***X*XX***X*X*XX**X***X***XX***XXX****X*******XX***X*X***
*X*XX*X***X**X*X*XXX**X*XX*X***X*****XXXXX***X*X**X*X**X**X***X*X*X*X***XX*X****X*XX*XX*X**XX*X*X*X*X***XX****XXXX*X***X**XX***XX***XXX***XXX**XX*XX**XXXXX**XX*
*X****XXXX*X*X**X***XXX**X**X*X**XX*X******XX*X**X****X*X**X*X****X*X*XX***XX*X*XX****X**XXX*XX***X*X*XX*XXX*X******X*X*X***X*XX**XX****X*X***X*X***XX******X*X*
**X*XX*****X*XX***X*****X*X*X*X*XXX***XX*XX***X*X**XX***X*XX**XX*X***XX**XX**XX**X*XX*XX*******X*X**X******XX**XX*XX****X*X**X***X*X*X*X*X**XXX**XX*X**XX*X***X*
X*X***X*X*X***X*XX*XX*XXX***X*X*XX*XXXX****XX*X***X**XXX****X**X**X*X***X***X***X**X***XXXX*XX**X*X**X*X*X***X***X***X*X**X*X**X*X***X*X*X*X****X*****X****XXX**
X*X*X**X****X**X*****X****XX**X****X***X*X*XX**XX*XX****XXX**X**X*X***XX**X*X*XX**X*XX*****X***X****X*X*X*XX**X*XX*X**X**XXX**XX*X*XXX***X***XX**X*XXX*X*X*X***X
**X**X**XX*XXX***XXX*X*X*XX**X*X*XXX*X*X*X***X*****X*XX****X**X**X**X*X**XX****X*X***XXXX*X**XX**X*X*******XX*X*****XX**X*X**XX**X*X**X*X*XXX**X**XX****X**X*XX*
*X*X**X*X***X*XXX*****X**X**X***X****X*X**XX*X*XXXXX*X*XXX**X**X**XX***X***XXXX**X*X****X**X*X**X**X*XXXXX****X*XXXX***X***XXX**X****X********X**X***XX**X*X*X**
****X*X*XXXX****X*X*X*X*X**X**X*X*X*XX**X*X***X******X***X*X*X**X*X**X**X*X****X*X**X*X**X*X*XX**X*X*X****XX*X**X****X*X*X****X*X*X*XX*X*X*X*X**X**XX**X***X**X*
XXX**XX****X*XX**X**X**X**XXX**X**XX**X*X**X*XX*X*XXX**X*X*X**X*X**X**X**XX*XX*X**X**X**X**X**XX*X*X**X*XX**X*XX**XXX**X**X*X*XXX**X***X**XXXX*X**X***X*XX*X*X**
**XX***XXX*****X**XX*X**X*XXXX***X***XX*X*XX*X**XX**X*X**X**X*X**X**XX*X*X**X**XX**X*X*X*X**X****XX*X*X****X***X*X****X**X**X****X*X*XX*X**X***XX***X*X****X**X*
X***XX***XX*X*X*X*X***X*X**XXXX*XXX*X***XX***X*X***X**XX*XX****X**X*X**X***XX*X**X*X*X***X*XX*XX****X*XX*XX**X***X*X*X**X*XX*XX*X**X*X****XX*XX**XX*X**XXXX*X***
**X***XX***X*X****X*X*X**X***XX**X****X****X*X***X*X*X*****XXX**X***X*X*XXX****X***X**X*XX***X**XXX*X**X**X*X*XX**X*X**X******X*XX*X*X*XXX***XXX***X*X*X*****X*X
*X*XX**XXX*X*X*XXX**XX*X**XX***X**X*X**XXXX***XXX**X*XX*XX***XX**XXX*******XX*X**X*X*XX***XX**X***X**X**X***X**XX*****X**XX*X*X****X*X*X***XX*XX*X***X***XX*X**X
*X***X***X*X***X**X*****X**X*X**X*X**XX***X*X****X*X***X*XXX**X*X**X*XX*X*X***X*XX**X***XX***X**X**X*X*X**X*XX***XXX*X**X*X*X*XXXXX***X**XXX******X*X*X*X*X*XX**
**X*X*X*XX*XX*X*X**X*X*X*X**XXX*X**XX***X**XXXXX*X*X*X*X***X*X***X*****XXXX*XX****X*X*X*X**XXX*X*X***X**XX****X*X***X*X*X****X******XX**X***XX*XXX*****X**X***X*
X*X***X*****X*X*XX***XX***X*XX**XX*X**X**X**X***X***XX*X*X****XX**XX*X**X****XXXXX**X**XX*X***X***XXX*X*X**X*X***XX****XX*X*X**XXXXX*X*X**X***XX***X*X**X**XX*X*
****X**X*XX***X****X****X******X*****XXX**X***X***X****X**X*X***X*****X***XX*******XXX******X***X*******X*X****X****XX****X**X***********X**X****XX***X***X*****